"filename", "language", "C++", "Objective-C", "comment", "blank", "total"
"f:\CylinderTag\CylinderTag\CylinderTag.cpp", "C++", 66, 0, 3, 10, 79
"f:\CylinderTag\CylinderTag\CylinderTag_detector.m", "Objective-C", 0, 584, 0, 45, 629
"f:\CylinderTag\CylinderTag\corner_detector.cpp", "C++", 5, 0, 0, 3, 8
"f:\CylinderTag\CylinderTag\cylinderTag_gen.m", "Objective-C", 0, 145, 0, 12, 157
"f:\CylinderTag\CylinderTag\header\CylinderTag.hpp", "C++", 24, 0, 6, 13, 43
"f:\CylinderTag\CylinderTag\header\config.hpp", "C++", 11, 0, 2, 3, 16
"f:\CylinderTag\CylinderTag\header\corner_detector.hpp", "C++", 29, 0, 0, 14, 43
"f:\CylinderTag\CylinderTag\header\corner_localize.hpp", "C++", 14, 0, 0, 5, 19
"f:\CylinderTag\CylinderTag\main.cpp", "C++", 37, 0, 1, 11, 49
"Total", "-", 186, 729, 12, 116, 1043