"filename", "language", "C++", "Objective-C", "comment", "blank", "total"
"f:\CylinderTag\CylinderTag\CylinderTag.cpp", "C++", 54, 0, 27, 17, 98
"f:\CylinderTag\CylinderTag\CylinderTag_detector.m", "Objective-C", 0, 584, 0, 45, 629
"f:\CylinderTag\CylinderTag\corner_detector.cpp", "C++", 235, 0, 21, 30, 286
"f:\CylinderTag\CylinderTag\corner_localize.cpp", "C++", 3, 0, 0, 1, 4
"f:\CylinderTag\CylinderTag\cylinderTag_gen.m", "Objective-C", 0, 145, 0, 12, 157
"f:\CylinderTag\CylinderTag\header\CylinderTag.h", "C++", 28, 0, 6, 14, 48
"f:\CylinderTag\CylinderTag\header\config.h", "C++", 15, 0, 2, 3, 20
"f:\CylinderTag\CylinderTag\header\corner_detector.h", "C++", 61, 0, 7, 24, 92
"f:\CylinderTag\CylinderTag\header\corner_localize.h", "C++", 15, 0, 0, 7, 22
"f:\CylinderTag\CylinderTag\main.cpp", "C++", 34, 0, 4, 11, 49
"Total", "-", 445, 729, 67, 164, 1405