"filename", "language", "C++", "Objective-C", "comment", "blank", "total"
"f:\CylinderTag\CylinderTag\CylinderTag.cpp", "C++", 121, 0, 2, 32, 155
"f:\CylinderTag\CylinderTag\CylinderTag_detector.m", "Objective-C", 0, 584, 0, 45, 629
"f:\CylinderTag\CylinderTag\corner_detector.cpp", "C++", 739, 0, 107, 86, 932
"f:\CylinderTag\CylinderTag\corner_localize.cpp", "C++", 3, 0, 0, 1, 4
"f:\CylinderTag\CylinderTag\cylinderTag_gen.m", "Objective-C", 0, 145, 0, 12, 157
"f:\CylinderTag\CylinderTag\header\CylinderTag.h", "C++", 30, 0, 6, 14, 50
"f:\CylinderTag\CylinderTag\header\config.h", "C++", 15, 0, 7, 4, 26
"f:\CylinderTag\CylinderTag\header\corner_detector.h", "C++", 107, 0, 14, 36, 157
"f:\CylinderTag\CylinderTag\header\corner_localize.h", "C++", 15, 0, 0, 7, 22
"f:\CylinderTag\CylinderTag\main.cpp", "C++", 42, 0, 6, 13, 61
"Total", "-", 1072, 729, 142, 250, 2193