"filename", "language", "C++", "Objective-C", "comment", "blank", "total"
"f:\CylinderTag\CylinderTag\CylinderTag.cpp", "C++", 76, 0, 26, 21, 123
"f:\CylinderTag\CylinderTag\CylinderTag_detector.m", "Objective-C", 0, 584, 0, 45, 629
"f:\CylinderTag\CylinderTag\corner_detector.cpp", "C++", 358, 0, 23, 39, 420
"f:\CylinderTag\CylinderTag\corner_localize.cpp", "C++", 3, 0, 0, 1, 4
"f:\CylinderTag\CylinderTag\cylinderTag_gen.m", "Objective-C", 0, 145, 0, 12, 157
"f:\CylinderTag\CylinderTag\header\CylinderTag.h", "C++", 29, 0, 6, 14, 49
"f:\CylinderTag\CylinderTag\header\config.h", "C++", 15, 0, 2, 3, 20
"f:\CylinderTag\CylinderTag\header\corner_detector.h", "C++", 78, 0, 10, 28, 116
"f:\CylinderTag\CylinderTag\header\corner_localize.h", "C++", 15, 0, 0, 7, 22
"f:\CylinderTag\CylinderTag\main.cpp", "C++", 34, 0, 4, 11, 49
"Total", "-", 608, 729, 71, 181, 1589